   G   G  
 ┌───┬───┐
 │   │   │
 │   g   │
 │   │   │
 ├───┼───┤
 │   │   │
 │   │   g
 │   │   │
ɢ┴───┴───┘