┌─┬─┬─────ʏ
│ │ │     │
├─┼─┤     │
│R│ U     │
├─┼r┼─────┤
r │Yᵘ     │
├─┼─┼─────y
ᵤ │Ru     │
├─┼─┤     │
│ │ │     │
ʀ─┴─┴─────┘