┌─┬─┬─────┐
│ │ │     │
├─┼─┤     │
│ │ │     │
├─┼─┼─────┤
│ │ │     │
├─┼─┼─────┤
│ │ │     │
├─┼─┤     │
│ │ │     │
└─┴─┴─────┘