 ʙB        
 ├─┬──┬──┬ʏ
 bR│  y  │ 
 ├─┼──┼──┤ 
 │Y│  │  │ 
 ├─┼──┼──┤ 
 │ │ B│  │ 
 ├─┼──┼──┤ 
 │ │  │  │ 
ʀr─┴──┴──b 