 ╷         
 ├─┬──┬──┬╴
 │ │  │  │ 
 ├─┼──┼──┤ 
 │ │  │  │ 
 ├─┼──┼──┤ 
 │ │  │  │ 
 ├─┼──┼──┤ 
 │ │  │  │ 
╶┴─┴──┴──┘ 