┌─┐ ┌─┐ ┌─┐
rRr │R│ │R│
└─○─○─○─○─┘
  │Y│ │Y│  
 ┌┴─┘ r─┴y 
 │       y 
 │       │ 
 │       │ 
 │       │ 
 │       │ 
 ʀ      ʏ┘ 
