┌─┐ ┌─┐ ┌─┐
│ │ │ │ │ │
└─┼─┼─┼─┼─┘
  │ │ │ │  
 ┌┴─┘ └─┴┐ 
 │       │ 
 │       │ 
 │       │ 
 │       │ 
 │       │ 
 ╵      ╶┘ 
