       R   
ʀr─┬─┬─┬┬┐B
 │ │ │ ├b┼┐
 ├─y─b─┼┴r┘
 │ │ │ │ │ 
 │R│Y│B│ │ 
ʏy─┼─┼─┼─bʙ
 │ │ │R│ │ 
 ├─┼─┼─r─┤ 
 │ │Y│B│ │ 
 └─┴─┴─┴─┘ 