           
╶┬─┬─┬─┬┬┐ 
 │ │ │ ├┼┼┐
 ├─┼─┼─┼┴┼┘
 │ │ │ │ │ 
 │ │ │ │ │ 
╶┼─┼─┼─┼─┼╴
 │ │ │ │ │ 
 ├─┼─┼─┼─┤ 
 │ │ │ │ │ 
 └─┴─┴─┴─┘ 