     R   
r───┬───┐
│   │   │
│ ┌─┼─┐ │
│ rR│ │ │
├─┴─┼─┴─┤
│   │   │
│   │   │
│   │   │
└───ʀ───┘
