         
┌───┬───┐
│   │   │
│ ┌─┼─┐ │
│ │ │ │ │
├─┴─┼─┴─┤
│   │   │
│   │   │
│   │   │
└───┴───┘
