┌─┬─┬─y─┬─ʏ
│ │ │ │ │ │
├r┼─┼─┴─┼─┤
│Y│ │   │ │
├─┼─┤   ├─y
│ │R│   │ │
├─┴─┼─┬─┼─┤
│   │ │ │Y│
│   ├r┼─┼─┤
│ R │ │Rr │
ʀ───┴─┴─┴─┘