┌─┬─┬─┬─┬─┐
│ │ │ │ │ │
├─┼─┼─┴─┼─┤
│ │ │   │ │
├─┼─┤   ├─┤
│ │ │   │ │
├─┴─┼─┬─┼─┤
│   │ │ │ │
│   ├─┼─┼─┤
│   │ │ │ │
└───┴─┴─┴─┘