         ┌┐
 ╶─┬──┬──┼┘
   │  │  │ 
   ├──┼──┤ 
┌┐ │  │  ├┐
└┼─┼──┼──┼┘
 │ │  │  │ 
 ├─┼──┼─┬┤ 
 │ │  │ ├┴┐
┌┼─┴─┬┴─┤ │
└┘   ╵  └─┘