    R    
    ╷ R  
┌───┼───┐
│ R │   │
├───┼─r─┤
│   │   u
├───ʀ─Ur┤
│   │   │
│   │   │
r   │   │
└─ᵘ─┴───┘