         
    ╷    
┌───┼───┐
│   │   │
├───┼───┤
│   │   │
├───┼───┤
│   │   │
│   │   │
│   │   │
└───┴───┘