    G      
    ╷      
    │  ɢ B 
 ┌──┼b─┼─┐ 
 g  │  │ │ 
 ├──┼──┼r┤ 
 │  │  │ │R
ʀ┼──┼──┼─┼╴
 │  │  │ │ 
 └──┼──┼─┘ 
    ʙ  ╵   