           
    ╷      
    │  ╷   
 ┌──┼──┼─┐ 
 │  │  │ │ 
 ├──┼──┼─┤ 
 │  │  │ │ 
╶┼──┼──┼─┼╴
 │  │  │ │ 
 └──┼──┼─┘ 
    ╵  ╵   