┌───┬──┐
│R  │ R│
├─┬─r──┤
│ │ │ R│
│ │ ├──┤
r─r r R│
│ │ ├──┤
│ │ │  │
└─┴─┼──┘
    ʀ   