┌───┬──┐
│   │  │
├─┬─┼──┤
│ │ │  │
│ │ ├──┤
├─┤ │  │
│ │ ├──┤
│ │ │  │
└─┴─┼──┘
    ╵   