  B R R B  
╶┬─┬─┬─┬─┬╴
 │ │ │ │ │ 
 ├─┼b┼─┼─┤ 
 │ r │ │ │ 
 r─┼─┼─┼─b 
 │ │ │ │ │ 
 ├─┴─┼─┴─┤ 
 ʀ   ʙ   ɢ 