           
╶┬─┬─┬─┬─┬╴
 │ │ │ │ │ 
 ├─┼─┼─┼─┤ 
 │ │ │ │ │ 
 ├─┼─┼─┼─┤ 
 │ │ │ │ │ 
 ├─┴─┼─┴─┤ 
 ╵   ╵   ╵ 