┌─b─┬─┬─┬─┐
│   │ │ │R│
├─ʙ─┤ │ ├─┤
│   │ │ │R│
├─r─┴─┴─┼─┘
│       │  
├─┬─┬─r─┼─┐
│ │ │   │ │
│ │ ├─ʀ─┼─┤
│B│ │   │ │
└─┴─┴───┴─┘