┌───┬─┬─┬─┐
│   │ │ │ │
├───┤ │ ├─┤
│   │ │ │ │
├───┴─┴─┼─┘
│       │  
├─┬─┬───┼─┐
│ │ │   │ │
│ │ ├───┼─┤
│ │ │   │ │
└─┴─┴───┴─┘