┌─y─┬───┬─ʏ
│Y│ │  R│Y│
├─y─┤ ┌─┼─┤
│Y│ │ │ │ │
y─┴─┼─┼─┘ │
│   │R│R  │
│ ┌─r─r─┬─┤
│ │ │ │ │ │
├─┼─┘ ├─r─┤
│ │   │ │ │
ʀ─┴───┴─┴─┘