┌─┬─┬───┬─┐
│ │ │   │ │
├─┼─┤ ┌─┼─┤
│ │ │ │ │ │
├─┴─┼─┼─┘ │
│   │ │   │
│ ┌─┼─┼─┬─┤
│ │ │ │ │ │
├─┼─┘ ├─┼─┤
│ │   │ │ │
└─┴───┴─┴─┘