 ┌───┬───┐ 
R│  G│   │ 
╶┼─┬─┼─┬─┼ɢ
 │ │ │B│ │ 
 ├─┼─g─┼b┤ 
 │ │ │ │ │ 
 ├─┼─r─┼─┤ 
 │ │ │ │ │ 
ʙ┴─┴─┴─┴─┴ʀ