 ┌───┬───┐ 
 │   │   │ 
╶┼─┬─┼─┬─┼╴
 │ │ │ │ │ 
 ├─┼─┼─┼─┤ 
 │ │ │ │ │ 
 ├─┼─┼─┼─┤ 
 │ │ │ │ │ 
╶┴─┴─┴─┴─┴╴