          
 ┌───┬───┐
 │   │   │
 │   │   │
 │   │   │
 ├───┼───┤
 │   │   │
 │   │   │
 │   │   │
╶┴───┴───┘