     ʀ     
 R  ┌┴────┐
┌───┤     │
│   │     │
│   │   B │
├───b───╴ │
│   │     │
│  ┌r┐    │
└──┤ ├────┘
   ʙ─┘     