     ╷     
    ┌┴────┐
┌───┤     │
│   │     │
│   │     │
├───┼───╴ │
│   │     │
│  ┌┴┐    │
└──┤ ├────┘
   └─┘     