           
 ┌┬─┬┬┬─┬┐ 
╶┼┘ └┼┘ └┼╴
 │   │   │ 
 ├┐ ┌┼┐ ┌┤ 
 ├┼─┼┼┼─┼┤ 
 ├┴─┴┼┴─┴┤ 
 │   │   │ 
╶┼┐ ┌┼┐ ┌┼╴
 └┴─┴┴┴─┴┘ 