  Y   R  
┌───┬───┐
│   │   │
│ G │   │
├───┼───┤
├─b─┼ryg┤
│   │   │
│   │ B │
└───┼───┘
    ᴡ    