         
┌───┬───┐
│   │   │
│   │   │
├───┼───┤
├───┼───┤
│   │   │
│   │   │
└───┼───┘
    ╵    