  Y     Y  
 ┌─┬─U─┬─┐ 
 │ │  B│ │R
╶┼y┼───┼─┼╴
 │ │   │ │ 
 ├─┼───┼ᵘ┤ 
 │G│   u │ 
ʀr─┼───┼─gɢ
 │ │   │ │ 
 └b┴───┴y┘ 
  ʙ     ʏ  