           
 ┌─┬───┬─┐ 
 │ │   │ │ 
╶┼─┼───┼─┼╴
 │ │   │ │ 
 ├─┼───┼─┤ 
 │ │   │ │ 
╶┼─┼───┼─┼╴
 │ │   │ │ 
 └┬┴───┴┬┘ 
  ╵     ╵  