    Y      
 ┌───┬───┐ 
 │   │G  │ 
 │ ┌─┼─┐ │ 
 │ │ │ │ │ 
ʏy─y─┼─┼─┼ɢ
 │ │ g │ │ 
 │ g─┼─┘ │ 
 │  Y│G  │ 
 └───┴───┘ 