           
 ┌───┬───┐ 
 │   │   │ 
 │ ┌─┼─┐ │ 
 │ │ │ │ │ 
╶┼─┼─┼─┼─┼╴
 │ │ │ │ │ 
 │ └─┼─┘ │ 
 │   │   │ 
 └───┴───┘ 