┌───┬───┐
│  B│   │
│ b─┼─b │
│B│ │ │ │
├─┼─ʙ─┼─b
│ │ │B│ │
│ └─┼─┘ │
│   │   │
└───┴───┘
