    ʀ    
┌ᵘr─┴───┐
│ │   R │
│ ├─┬u╴ │
│ URᵤ   │
│ └─r───┤
│   │   │
│   │   │
└───┴───┘