    ╷    
┌─┬─┴───┐
│ │     │
│ ├─┬─╴ │
│ │ │   │
│ └─┼───┤
│   │   │
│   │   │
└───┴───┘