           
   ┌─┬─┐   
   │ │ │   
 ┌─┼─┼─┼─┐ 
 │ │ │ │ │ 
╶┼─┼─┼─┼─┼╴
 │ │ │ │ │ 
 └─┴─┴─┴─┘ 