ʀ──┐   ┌──g
│  │   │  │
│  │   │  │
└┬─┼───┼─┬┘
 gG│G R│R│ 
 ├─┼───┼─┤ 
 │ │   │ r 
┌┴─┼───┼─┴┐
│  │   │  │
│  │   │  │
r──┘   └──ɢ