┌──┐   ┌──┐
│  │   │  │
│  │   │  │
└┬─┼───┼─┬┘
 │ │   │ │ 
 ├─┼───┼─┤ 
 │ │   │ │ 
┌┴─┼───┼─┴┐
│  │   │  │
│  │   │  │
└──┘   └──┘