┌─┬──┬──┬─ʏ
│ │  │  │ y
│ │Y │  │ │
├─┼──y──┴─y
│R│  │   Y│
r─┼──┼─┬──┤
│ │ Y│R│  │
│ ├──r─┴┐ │
│ │  │  r─┤
│ │  │  │R│
ʀ─┴──┴──┴─┘