┌─┬──┬──┬─┐
│ │  │  │ │
│ │  │  │ │
├─┼──┼──┴─┤
│ │  │    │
├─┼──┼─┬──┤
│ │  │ │  │
│ ├──┼─┴┐ │
│ │  │  ├─┤
│ │  │  │ │
└─┴──┴──┴─┘