┌─────┬───┐
│   Y │   │
│   ╷ │   │
├──┬┴─y─y │
│  │  │ │ │
│  │  │Y│ │
│  └──r─┴─┤
rR    │R  │
├─────┼─╴ │
│     │   │
ʀ─────┴───ʏ