┌─────┬───┐
│     │   │
│   ╷ │   │
├──┬┴─┼─┐ │
│  │  │ │ │
│  │  │ │ │
│  └──┼─┴─┤
│     │   │
├─────┼─╴ │
│     │   │
└─────┴───┘