 R G  B  
┌───────┐
│       │
r       │
│       │
└───g───┘
    │    
┌───┴──b┐
│       │
└───ᴡ───┘