         
┌───────┐
│       │
│       │
│       │
└───┬───┘
    │    
┌───┴───┐
│       │
└───────┘