         Y
         ╷
ʀ┬─┬─┬─┬─┤
 │ │ │ │ │
 ├─┼─┼─┼r┤
 │R│ rRyR│
 ├─┼r┼─┼─┤
R│ │ │ │ │
╶┼─┼─┼─┼─┤
 │ │ │ │ │
 ʏ └r┴─┘ ʀ