          
         ╷
╶┬─┬─┬─┬─┤
 │ │ │ │ │
 ├─┼─┼─┼─┤
 │ │ │ │ │
 ├─┼─┼─┼─┤
 │ │ │ │ │
╶┼─┼─┼─┼─┤
 │ │ │ │ │
 ╵ └─┴─┘ ╵