┌────ʏ────┐
│    │ Y  │
│  ┌U┼─┐  │
│ G│ │B│R │
│ ┌┼y┼─┼┬─┤
ʀ─┤│ U b├─ʙ
│ └┼─g─┼┘ │
│  │ │ │  │
├─┬┼─┼U┴─┬┤
│ ├┘ │   ᵘ│
└─r  ɢ───┴┘