┌────┬────┐
│    │    │
│  ┌─┼─┐  │
│  │ │ │  │
│ ┌┼─┼─┼┬─┤
├─┤│ │ │├─┤
│ └┼─┼─┼┘ │
│  │ │ │  │
├─┬┼─┼─┴─┬┤
│ ├┘ │   ││
└─┘  └───┴┘