    ʙ┬────┐
  ʀ  │    │
┌─┼──┼───b┤
│R│  │    │
├─┼U ┼────┤
│ │  │    │
├─┼──┼──r─┤
│ │  │  │ │
│ │  ᵘ  │ │
│B│  │  │ │
└─┴──┴──┴─┘