    ╶┬────┐
  ╷  │    │
┌─┼──┼────┤
│ │  │    │
├─┼──┼────┤
│ │  │    │
├─┼──┼──┬─┤
│ │  │  │ │
│ │  │  │ │
│ │  │  │ │
└─┴──┴──┴─┘