 ┌───┬───┐ 
 │ Y │   │ 
 │R╷ │R  r 
ʀ┼─┼─┼───┼ʏ
 │ │ │   │ 
 │ └─y───┤ 
 │   │   │ 
 └───r───┘ 