 ┌───┬───┐ 
 │   │   │ 
 │ ╷ │   │ 
╶┼─┼─┼───┼╴
 │ │ │   │ 
 │ └─┼───┤ 
 │   │   │ 
 └───┴───┘ 