ʀr─┬─┬───bʙ
 │R│R│R  │ 
 ├─┼─┼───┤ 
 │ │ │   │ 
ʙb─┴─┼─┬─rʀ
 │B  │B│ │ 
 ├───┼─┼─┤ 
 │B  │ │ │ 
ʀr───┴─┴─bʙ
