╶┬─┬─┬───┬╴
 │ │ │   │ 
 ├─┼─┼───┤ 
 │ │ │   │ 
╶┼─┴─┼─┬─┼╴
 │   │ │ │ 
 ├───┼─┼─┤ 
 │   │ │ │ 
╶┴───┴─┴─┴╴
