 B     B 
┌─┐   ┌─┐
│ │B  │ │
│ └── │ │
│     │ │
└─────┘ │
        │
ʙ─b─b─b─┘