         
┌─┐   ┌─┐
│ │   │ │
│ └─╴ │ │
│     │ │
└─────┘ │
        │
╶───────┘