         
┌─┐   ┌─┐
│ │   │ │
│ └── │ │
│     │ │
└─────┘ │
        │
╶───────┘