       G 
     ┌──┐
     │R │
 ┌r─g┼──┤
 │   │  │
R│ B r  │
╶┼───┼b─┤
 │   │  │
 │   │  │
ᴡ┴───┴──┘