         
     ┌──┐
     │  │
 ┌───┼──┤
 │   │  │
 │   │  │
╶┼───┼──┤
 │   │  │
 │   │  │
╶┴───┴──┘