  ┌──┬ᵘ─┐  
  │  │  │ B
┌─┼─U┼─I┼V┐
ᵛ │  │  │ V
│ │  │  │ │
└─┼─O┼──┼─┤
  │  │  │ │
  O  ᵒ  │ │
  │  ├──┼─┤
  │  │  │ │
 ʙb──┴─ⁱ┴─┘