  ┌──┬──┐  
  │  │  │  
┌─┼──┼──┼─┐
│ │  │  │ │
│ │  │  │ │
└─┼──┼──┼─┤
  │  │  │ │
  │  │  │ │
  │  ├──┼─┤
  │  │  │ │
 ╶┴──┴──┴─┘