 ┌───┬───┐ 
ʏ┤   │   │R
 │   │ ┌─┼╴
 │   y │ │ 
 ├───┼─┼─┤ 
 │   r │ │Y
 │   │ └─┼╴
ʀ┤   r  R│ 
 └───┴───┘ 
