 ┌───┬───┐ 
╶┤   │   │ 
 │   │ ┌─┼╴
 │   │ │ │ 
 ├───┼─┼─┤ 
 │   │ │ │ 
 │   │ └─┼╴
╶┤   │   │ 
 └───┴───┘ 
