 Y       R 
 ╶┬─────┬╴ 
  U     u  
┌─┼─────┼ᵤ┐
│ │     │ │
│ │     │ │
└─┼─────┼ᵘ┘
  r     y  
  ʀ     ʏ  