   B   G   
 ┌─┬──┬──┐ 
 │B│  │  │ 
┌┼─┼──┼──┼┐
b│ │  │ Gb│
└┼─┼──g──┼┘
 │ g  │  │ 
ɢ┴─┴──┴──┴ʙ