           
 ┌─┬──┬──┐ 
 │ │  │  │ 
┌┼─┼──┼──┼┐
││ │  │  ││
└┼─┼──┼──┼┘
 │ │  │  │ 
╶┴─┴──┴──┴╴