┌─────────┐
│┌───────┐│
││┌─────┐││
│││┌───┐│││
││││ B ││││
│││└─┐ ││││
└┼┘  │ ││││
B└───┼─┘│││
╶────┼──┘││
ʙ────┼b──┘│
     └b───┘