┌─────────┐
│┌───────┐│
││┌─────┐││
│││┌───┐│││
││││   ││││
│││└─┐ ││││
└┼┘  │ ││││
 └───┼─┘│││
╶────┼──┘││
╶────┼───┘│
     └────┘