 R   Y   G 
┌─┐ ┌─┐ ┌─┐
│ │ │ │ u U
u u │ ᵤ │ │
├r┤ ├─┤ ├g┤
U u u u u U
├─┤ │ │ ├─ᵘ
│ │ ├─┤ │ │
│ │ │ │ │ │
├─┤ y─┤ ├─┤
╵ ʀ ʏ ╵ ɢ ╵