 ʙ   Y     
 ├─┬──y──┬ʏ
 │ │  │  │ 
 │ │  │  │ 
 │ │Y │BR│ 
 ├─b──y──┤ 
 │ │  │  │ 
 ├─┼r─┼──┘ 
 │ │  │    
ʀ┴─┴──┘    