 ╷         
 ├─┬──┬──┬╴
 │ │  │  │ 
 │ │  │  │ 
 │ │  │  │ 
 ├─┼──┼──┤ 
 │ │  │  │ 
 ├─┼──┼──┘ 
 │ │  │    
╶┴─┴──┘    