┌─┐     ┌─┐
│B│     r │
└─┼─┐ ┌─┼─┘
  │B│ │R│  
 ┌┴─┼┬┼─┴┐ 
 ʀ  b┼┤  ʙ 
 └┬─┼┴┼─┬┘ 
  │ │ │ │  
┌─┼─┘ b─┼─┐
│ │     │ │
└─┘     └─┘