┌─┐     ┌─┐
│ │     │ │
└─┼─┐ ┌─┼─┘
  │ │ │ │  
 ┌┴─┼┬┼─┴┐ 
 │  ├┼┤  │ 
 └┬─┼┴┼─┬┘ 
  │ │ │ │  
┌─┼─┘ └─┼─┐
│ │     │ │
└─┘     └─┘