ʀ──┐  ┌─┐  
│ Y│  │ │  
└┬─┼──┼y┼─┐
 │Yr  │Rr │
 ├─┼──┼─┤ │
 │ │  │R│ │
┌┴y┼──┼─┼─┘
│  │  │ │  
ʏ──┘  └─┘  