┌──┐  ┌─┐  
│  │  │ │  
└┬─┼──┼─┼─┐
 │ │  │ │ │
 ├─┼──┼─┤ │
 │ │  │ │ │
┌┴─┼──┼─┼─┘
│  │  │ │  
└──┘  └─┘  