      B    
 ┌───┬───┐ 
 │   │   │ 
 │ ┌─y   V 
 │ │ │   │ 
ʏ┼─┴ᵘ┼─U─┼ʙ
 │   │   │ 
 │   b─┐ ᵛ 
 │  Y│ │ │ 
 └───┼─┼─┘ 
     └─┘   