           
 ┌───┬───┐ 
 │   │   │ 
 │ ┌─┤   │ 
 │ │ │   │ 
╶┼─┴─┼───┼╴
 │   │   │ 
 │   ├─┐ │ 
 │   │ │ │ 
 └───┼─┼─┘ 
     └─┘   