    B      
 ┌───┬───┐ 
 │   │   │ 
 │   r R │ 
ʙb───┼r──┼ʀ
 │ G │   │ 
 ├───g───┤ 
 │   │   │ 
 │   │ R │ 
ʀ┴───┴───┴ɢ
