           
 ┌───┬───┐ 
 │   │   │ 
 │   │   │ 
╶┼───┼───┼╴
 │   │   │ 
 ├───┼───┤ 
 │   │   │ 
 │   │   │ 
╶┴───┴───┴╴
