┌────┬────┐
│    │ R  │
│ ┌──┼──┐ │
│ │  │  │ │
│ y  │  │ │
ʀ─┼──┼──┼─ʏ
│ │  r  │  
│ │  │ Y│R 
│ └──┼──┼─┐
│    │  │ │
└────┘  └─r