┌────┬────┐
│    │    │
│ ┌──┼──┐ │
│ │  │  │ │
│ │  │  │ │
├─┼──┼──┼─┘
│ │  │  │  
│ │  │  │  
│ └──┼──┼─┐
│    │  │ │
└────┘  └─┘