 ┌─┬──┬──┐ 
 │ │ B│  │ 
 ├─┼──┼──┤ 
 │ │ B│R │ 
 b─r──┼──┤ 
 │B│  │  │ 
 ├─┼──b──b 
 │ │  │  │ 
ʀ┴─┴──┴──┴ʙ
