 ┌─┬──┬──┐ 
 │ │  │  │ 
 ├─┼──┼──┤ 
 │ │  │  │ 
 ├─┼──┼──┤ 
 │ │  │  │ 
 ├─┼──┼──┤ 
 │ │  │  │ 
╶┴─┴──┴──┴╴
