┌y┐   ┌──┐
│ │   │ Y│
└─┼───┼──┤
  │   │  │
  │   r  │
  │ R │  │
 ʏ┼───┘  │
  │      │
 ʀ┴──────┘