┌─┐   ┌──┐
│ │   │  │
└─┼───┼──┤
  │   │  │
  │   │  │
  │   │  │
 ╶┼───┘  │
  │      │
 ╶┴──────┘