    G B R R
╶┬─┬─┬─┬─┬╴
 │ g │ │ │ 
 r─┼─┼─┼─┤ 
 │ │ │ │ │ 
 ├─r─b─┼─┤ 
 │ │ │ │ │ 
 ├─┴─┼─┴─┤ 
 ʀ   ʙ   ɢ 