  G        
 ┌─┬─┬─┬─┐ 
 │ │B│ │Y│ 
 ├─┼─┼─┼─┤ 
 │ g y │ │ 
ɢ┼─┼─┼─┼─┼ʏ
 │ │ │ │ │ 
 ├─┼g┼─┼b┤ 
 │ │ │G│ │ 
 └─┴─┼─┴─┘ 
     ʙ     