           
 ┌─┬─┬─┬─┐ 
 │ │ │ │ │ 
 ├─┼─┼─┼─┤ 
 │ │ │ │ │ 
╶┼─┼─┼─┼─┼╴
 │ │ │ │ │ 
 ├─┼─┼─┼─┤ 
 │ │ │ │ │ 
 └─┴─┼─┴─┘ 
     ╵     