  Y        
ʀ┬───┬───┬ʙ
 │   │   │ 
 │   │   │ 
 │   │ RB│ 
 ├───○───b 
 │G  │   │ 
 ├─┬─○─┬─┤ 
 │ │ │ │ │ 
 ʏ─yrg─┴─┴ɢ