           
╶┬───┬───┬╴
 │   │   │ 
 │   │   │ 
 │   │   │ 
 ├───┼───┤ 
 │   │   │ 
 ├─┬─┼─┬─┤ 
 │ │ │ │ │ 
 └─┴─┴─┴─┴╴