 ┌───┬───┐ 
 │   │   │ 
Y│   │   │R
╶┤ ┌─┼─┐ ├╴
 │ │ │ U │ 
 │ ᵘ └ur │ 
 ᵤ │   │ │ 
 y─┼───┼─┘ 
   ʀ   ʏ   