 ┌───┬───┐ 
 │   │   │ 
 │   │   │ 
╶┤ ┌─┼─┐ ├╴
 │ │ │ │ │ 
 │ │ └─┤ │ 
 │ │   │ │ 
 └─┼───┼─┘ 
   ╵   ╵   