        Y R
 ┌───┬─┬─┬╴
 │   │ │ │ 
 │   r─┼─┤ 
 │   │Y│ │ 
 y─┬─┼─┴─┤ 
 │ │ │   │ 
 r─┼─┤   │ 
 │ │R│   │ 
ʀ┴─┴─┴───yʏ