           
 ┌───┬─┬─┬╴
 │   │ │ │ 
 │   ├─┼─┤ 
 │   │ │ │ 
 ├─┬─┼─┴─┤ 
 │ │ │   │ 
 ├─┼─┤   │ 
 │ │ │   │ 
╶┴─┴─┴───┴╴