 Y   R  B  
┌─┬──┬──┬─┐
│ │  r  │ │
│ ├─y┼──┤ │
│ │  │  │ │
└─┼──┼──┼─b
  │  │  │  
  ʀ  ʙ  └ʏ 