           
┌─┬──┬──┬─┐
│ │  │  │ │
│ ├──┼──┤ │
│ │  │  │ │
└─┼──┼──┼─┘
  │  │  │  
  ╵  ╵  └╴ 