R  ┌───┐  Y
╶──┼─┬─┼──╴
   │ │ │   
  ┌┴─┼─┴┐  
  │  │R │  
┌─┼──┴──┼─┐
│ │     │ │
r y     │ r
└─┼─────┼─┘
  │     │  
ʀ─┴─────┴─ʏ