  B R R B  
╶┬─┬─┬─┬─┬╴
 │ │ │ │ │ 
 ├─r─┼─┼─┤ 
 │ │ │ │ │ 
 ├─┼r┼─┼─┤ 
 │ │ │ │ │ 
 ├─┴b┼─┴─b 
 ʀ   ʙ   ╵ 