     Y     
     ╷   Y 
┌─┬O─┼─ⁱ┬─┐
│ │  │  │ v
y─┼ᵒ─┼──┼─┤
V V  I  │ │
├─┼──┼──┤ │
│ │  │  │ ᵛ
ᵘ │  │  y │
└─┴──┼─U┴─┘
     ʏ     