           
     ╷     
┌─┬──┼──┬─┐
│ │  │  │ │
├─┼──┼──┼─┤
│ │  │  │ │
├─┼──┼──┤ │
│ │  │  │ │
│ │  │  │ │
└─┴──┼──┴─┘
     ╵     