   R     
┌───┬───┐
│   │   │
│ ┌─┼─┐ │
│ rR│ │ │
│ └─┘ │ │
└──r──┘ │
        │
ʀ───────┘