         
┌───┬───┐
│   │   │
│ ┌─┼─┐ │
│ │ │ │ │
│ └─┘ │ │
└─────┘ │
        │
╶───────┘