      ┌─┬─┐
  R ┌ᵒ┤ │ ⁱ
┌───┤ │ │ │
U   │ │ │ o
r   │ │ │ │
├───┼i┼─ᵘ─┤
│   │ │ │ ᵛ
│   │ ├─┴─┤
├───┤ v   i
│   │ │   │
ʀ───┘ └───┘