      ┌─┬─┐
  R ┌ᵒ┤ │ ⁱ
┌───┤ │ │ │
U   │ │ │ O
r   │ │ │ │
├───┼I┼─ᵘ─┤
│   │ │ │ ᵛ
│   │ ├─┴─┤
├───┤ V   I
│   │ │   │
ʀ───┘ └───┘