      ┌─┬─┐
    ┌─┤ │ │
┌───┤ │ │ │
│   │ │ │ │
│   │ │ │ │
├───┼─┼─┼─┤
│   │ │ │ │
│   │ ├─┴─┤
├───┤ │   │
│   │ │   │
└───┘ └───┘