┌───────ʀ
│      Y 
│ ┌─────┐
│R│     │
├─┼┐ʏ─┬─y
r ││Y ├─┤
│ └┼─y┘ │
│  │    │
└──┴────┘