┌───────╴
│        
│ ┌─────┐
│ │     │
├─┼┐╶─┬─┤
│ ││  ├─┤
│ └┼──┘ │
│  │    │
└──┴────┘