  ┌───┐    
  │   ├─┐  
  │R Y│ │  
  ├───┼─b─┐
  │   │ │ │
  │   │ │ │
ᴡ─┼───r─y─┤
  │   │ │ │
  │   │ │B│
  └───┴─┴─┘