  ┌───┐    
  │   ├─┐  
  │   │ │  
  ├───┼─┼─┐
  │   │ │ │
  │   │ │ │
╶─┼───┼─┼─┤
  │   │ │ │
  │   │ │ │
  └───┴─┴─┘