  R     R  
 ┌─┐   ┌─┐ 
 │ │   │G│ 
 ├─┼─┬─┼─r 
 │R│B│R│ │ 
ʙb─┼─┼─┼─gɢ
 │ │ │ │ │ 
 │ │ │ │ │ 
ʀ┼─┴r┴─┴─rʀ
 │       │ 
 └───r───┘ 
