           
 ┌─┐   ┌─┐ 
 │ │   │ │ 
 ├─┼─┬─┼─┤ 
 │ │ │ │ │ 
╶┼─┼─┼─┼─┼╴
 │ │ │ │ │ 
 │ │ │ │ │ 
╶┼─┴─┴─┴─┼╴
 │       │ 
 └───────┘ 