 B       R 
┌─┬─────┬─b
│ │     │ │
└─┼─────┼─┘
  │     │R 
r─┼─────┼─┐
│ │     │ │
│ r     │ │
└─┼─────┼─┘
  │     │  
  ʀ     ʙ  