           
┌─┬─────┬─┐
│ │     │ │
└─┼─────┼─┘
  │     │  
┌─┼─────┼─┐
│ │     │ │
│ │     │ │
└─┼─────┼─┘
  │     │  
  ╵     ╵  