    G      
    ╷  ɢ   
 ┌──┼──┼─┐ 
 │  │  │ │ 
 ├──┼──┼─r 
 │  │  │ │R
ʀ┼──┼──┼─b╴
 │  │  │B│ 
 g──┼──┼─┘ 
    ʙ  ╵   