       R B
 ┌─┬r┬───┐
 │ │ ├───┤
 │ │ │   │
ᴡ┼─┴─g─┬─┤
 │   │ │ │
 ├───┤ │ │
 │  G│ │ │
 └───┴─b─┘