          
 ┌─┬─┬───┐
 │ │ ├───┤
 │ │ │   │
╶┼─┴─┼─┬─┤
 │   │ │ │
 ├───┤ │ │
 │   │ │ │
 └───┴─┴─┘