    R G    
  ┌──┬──┐  
  │  │  │  
  │  │  │  
┌─┼──ʀ──y─┐
r │  │  │ │
│ │ Y│  │ │
ɢ─┼──┼──g─ʏ
│ │  │  │ │
│ │  │  │ │
└─┴──┴──┴─┘