           
  ┌──┬──┐  
  │  │  │  
  │  │  │  
┌─┼──┼──┼─┐
│ │  │  │ │
│ │  │  │ │
├─┼──┼──┼─┤
│ │  │  │ │
│ │  │  │ │
└─┴──┴──┴─┘