   Y R   
ʀy┬─┬─┬─ʏ
│ │ │ │ │
│ │ │ │ │
├─○─○─○─r
│ │ │ │ │
│ │ │ │ │
└─○─┴─○─┘
  │   │  
  └───┘  
