         
┌─┬─┬─┬─┐
│ │ │ │ │
│ │ │ │ │
├─┼─┼─┼─┤
│ │ │ │ │
│ │ │ │ │
└─┼─┴─┼─┘
  │   │  
  └───┘  
