  ┌──┬──┬ʏ 
  │  │ R│  
┌─r──┼──┼─┐
│R│  │  │Y│
├─┼──y──┼─┤
│Y│  │  │ │
└─r──┼──┼─┘
 ʀ┴──y──┘  