  ┌──┬──┬╴ 
  │  │  │  
┌─┼──┼──┼─┐
│ │  │  │ │
├─┼──┼──┼─┤
│ │  │  │ │
└─┼──┼──┼─┘
 ╶┴──┴──┘  