    ┌─┬─┬─ɢ
  ┌─┤ │G│ │
  │ ├─┼─┼─┤
  │ │B│ │G│
┌─g─┴┬g─┼─┤
│B│  │  │ │
├─b─┬┴┬─┼─┘
│ │ │ │ │  
├─b─┼─┤ │  
│ │ │ ├─┘  
ʙ─┴─┴─┘    