    ┌─┬─┬─┐
  ┌─┤ │ │ │
  │ ├─┼─┼─┤
  │ │ │ │ │
┌─┼─┴┬┴─┼─┤
│ │  │  │ │
├─┼─┬┴┬─┼─┘
│ │ │ │ │  
├─┼─┼─┤ │  
│ │ │ ├─┘  
└─┴─┴─┘    