     ┌──┐  
     │  │  
 R   ├b─┼─ʙ
┌─┬──┤B │Y│
│ │  ├──┼─┤
│ │  │  │ │
├y┼──┼──┼─┤
│ │  │  │ │
├─┴┬─r──┼─┤
│  │ │  │ │
ʀ──┴─┴──┴─ʏ