Y       R
┌──┬──┬─┐
│  u  ᵤ │
│  │  │ │
├U┬┼─┬┼─┤
│ ││ ││ ᵘ
│ ││ ││ │
├U┴┴─┴┴U┤
│       │
└r─────y┘
 ʀ     ʏ 