         
┌──┬──┬─┐
│  │  │ │
│  │  │ │
├─┬┼─┬┼─┤
│ ││ ││ │
│ ││ ││ │
├─┴┴─┴┴─┤
│       │
└┬─────┬┘
 ╵     ╵ 