┌─┐     ┌r┐
│ │     │ │
├─┤     ├─┤
U ᵛ     ᵒ │
├─┤     ├─┤
│ ├──V──┤ ⁱ
├─┤     ├r┤
│ │     IR│
├ᵘ┤     ├─┤
│ │     ORO
ʀ─┘     └─┘