┌─┐     ┌─┐
│ │     │ │
├─┤     ├─┤
│ │     │ │
├─┤     ├─┤
│ ├─────┤ │
├─┤     ├─┤
│ │     │ │
├─┤     ├─┤
│ │     │ │
└─┘     └─┘