  ┌─────┐  
 R│     │  
┌─┼─────┼─┐
│ g     │Gr
├─┼─┬─┬─┼─┤
│ │ │ │ │ │
│G│ │ │ g │
├─┼─┼─┼─┼─┤
│ │ │ │ │ │
└─┴─┼─┼─┴─┘
    ʀ ɢ    