  ┌─────┐  
  │     │  
┌─┼─────┼─┐
│ │     │ │
├─┼─┬─┬─┼─┤
│ │ │ │ │ │
│ │ │ │ │ │
├─┼─┼─┼─┼─┤
│ │ │ │ │ │
└─┴─┼─┼─┴─┘
    ╵ ╵    